10
10
0001111111
0001100002
0001100003
0001000004
0001000005
0001000006
0000000007
0000000000
0000000000
0000cba980