10
10
0000000001
1000000111
0001108011
0001100011
0010111111
0010000001
0012240001
0000240101
0000240101
0000000001