10
10
0000000000
0000000000
0001100000
0001100000
0000000000
0000000000
0000000000
0000000100
0111111100
0000000000