10
10
0000000000
0000000000
0000000000
0000020000
0c0000b000
0000000000
0002000000
0022222200
0222222200
2222222220