10
10
0000040900
0000040000
0001140000
0001100002
0014100002
0014100002
0014111002
0014121102
0111111102
0002222222